############
#A         #
# ####### ##
# #     #  #
# # ### ####
# # # #    #
#   # # ## #
##### # #  #
#     # ####
# ###     B#
# ##########
############