##########
#A       #
# ## ### #
# #    # #
# # ## # #
# # #  # #
# # #### #
# #     B#
# ###### #
##########