########
#A     #
# ### ##
# #   B#
# # # ##
#   #  #
#####  #
########